111111111111111111111111111111
10C0001001000000000000000000E1
100C00010010001001000000010101
100C00010010001001000000010101
100C000100100000000000000000C1
100C0001001000000C000000000001
100C00010010001001000000010101
100C00010010001001000000010101
100C000100100P00000000000000C1
100C00010010000000000000000001
100C00010010001001000000010101
100C00010010001001000000010101
100C000100100000000000000000C1
100C00010010000000000000000001
100C000100100000000000000000C1
100C0001001000000C000000000001
100C00010010001001000000010101
111111111111111111111111111111