1111111111111
1E010000000C1
10000111N1001
1P0011E000001
1111111111111