1111111111111111
10C00000000000E1
100C000010010101
1000000010010101
10000NNN000000C1
1000000000000001
1000000010010101
100C000010010101
1C00000P00N000C1
100C0000N0000001
100C000010010101
1111111111111111