1111111111111
1E010000000C1
10000111N1001
10011E00000P1
1111111111111