11111111111
10000000001
10000100101
10000100101
10000100101
1000PE00001
11111111111