1111111111111
1E010000000C1
1000011101001
10011000000P1
1111111111111